{
  "size": [16, 16],
  "tiles": [
    ["W", "W", "W", "W", "W", "W", "W", "W", "W", "W", "W", "W", "W", "W", "W", "W"],
    ["W", " ", " ", " ", "W", " ", " ", " ", " ", " ", " ", "W", " ", " ", " ", "W"],
    ["W", " ", "W", " ", "W", " ", "W", "W", "W", "W", " ", "W", " ", "W", " ", "W"],
    ["W", " ", "W", " ", " ", " ", " ", " ", " ", "W", " ", " ", " ", "W", " ", "W"],
    ["W", " ", "W", "W", "W", " ", "W", "W", " ", "W", "W", "W", " ", "W", " ", "W"],
    ["W", " ", " ", " ", "W", " ", " ", " ", " ", " ", " ", "W", " ", " ", " ", "W"],
    ["W", "W", " ", "W", "W", "W", " ", "W", "W", "W", " ", "W", "W", " ", "W", "W"],
    ["W", " ", " ", " ", " ", " ", " ", "W", " ", " ", " ", " ", " ", " ", " ", "W"],
    ["W", " ", "W", "W", "W", "W", " ", "W", " ", "W", "W", "W", "W", "W", " ", "W"],
    ["W", " ", " ", " ", " ", " ", " ", " ", " ", " ", " ", " ", " ", "W", " ", "W"],
    ["W", " ", "W", "W", "W", " ", "W", "W", "W", "W", "W", " ", "W", "W", " ", "W"],
    ["W", " ", "W", " ", " ", " ", " ", " ", " ", " ", "W", " ", " ", " ", " ", "W"],
    ["W", " ", "W", " ", "W", "W", "W", "W", "W", " ", "W", "W", "W", "W", " ", "W"],
    ["W", " ", " ", " ", " ", " ", " ", " ", "W", " ", " ", " ", " ", " ", " ", "W"],
    ["W", "P", "W", "W", "W", "W", " ", " ", "W", "W", "W", "W", "W", "W", "G", "W"],
    ["W", "W", "W", "W", "W", "W", "W", "W", "W", "W", "W", "W", "W", "W", "W", "W"]
  ],
  "player_start": [14, 1],
  "guards": [
    { "pos": [14, 14], "patrol": [[14, 14], [10, 10], [8, 10], [10, 10]] },
    { "pos": [3, 9], "patrol": [[3, 9], [7, 9], [3, 9]] },
    { "pos": [6, 6], "patrol": [[5, 6], [5, 9], [5, 6]] }
  ],
  "objectives": [
    { "pos": [1, 13] },
    { "pos": [12, 3] }
  ],
  "hide_spots": [
    [2, 1], [3, 7], [6, 11], [10, 13]
  ],
  "lights": [
    { "center": [8, 8], "radius": 2 },
    { "center": [4, 4], "radius": 1 }
  ]
}

